#####   
#   #   
# $ #   
### ### 
# .@  # 
#  $  # 
#  .  # 
####### 
