###########
#    L    #
# .# $ #. #
#  L   L  #
#@ $   $  #
#  ##.##  #
#    L    #
###########
