##########
#        #
#   T  # #
#   .  # #
######## #
#@       #
#   $  T #
##########