#############
#     .     #
# ###   ### #
# # $ $   # #
# #   @   # #
# # $ $   # #
# ###   ### #
#     .     #
# .       . #
#############