##############
#            #
#    @       #
#   ######   #
#...#    #   #
##### $  #   #
#   # $      #
# $ ######   #
#   ? ? ?    #
##########   #
         #####